нe бойся суда, бойся судьи	о том, что судья может несправедливо решить дело
sine qua non	то, без чего невозможно
а васька слушает, да ест	о том, кто не обращает внимания на уговоры и увещевания и продолжает делать своё (обычно предосудительное) дело
а ларчик просто открывался	применяется, когда говорят о каком-либо деле, вопросе, при разрешении которого нечего было мудрить
авось, да небось	не желание предпринимать для улучшения, или исправления ситуации, а просто ждет как ситуация будет развиваться дальше сама, без его участия
ад кромешный	место мучений, где условия невыносимы. ужасная суматоха
адвокат дьявола	о человеке, любящем сквернословить в чей-либо адрес, старающемся и в хорошем найти недостатки
адмиральский час	время выпить и закусить. (от времен
альма-матер	университет, институт, в котором учился
американские горки	нестабильность, разнонаправленное движение (движение в одну сторону неожиданно сменяется движением в другую сторону
аника-воин	о хвастливом человеке, бахвалящемся своей храбростью лишь находясь вдали от опасности
аннибалова (ганнибалова) клятва	твердая решимость бороться с кем- чем-нибyдь за что-нибудь до конца
бабий язык — чертово помело	об излишней разговорчивости некоторых женщин
батюшки мои!	употребляется при сильном изумлении, восхищении
баш на баш	вещь на вещь без доплаты, одно взамен другого (при обмене
башка на плечах	кто-либо умён, неглуп, сообразителен
без ветру и ветряк не будет крыльями махать	у любого события есть причина возникновения
без году неделю	несколько дней, недавно, краткий период времени
без задних ног спать	очень крепко, беспробудно
без лести предан	о людях, льстиво преклоняющихся перед влиятельным лицом
без ножа зарезать	причинить несчастье, беду, поставить в безвыходное положение, погубить
без порток, а в шляпе	насмешка над тем, кто одет смешно, с претензией
без порток, а в шляпе	о человеке, который одел на себя новую красивую вещь, вместе со старыми некрасивыми штанами, обувью, или другой плохой старой одеждой
без пяти минут	употребляется при подлежащем, обозначающем человека по профессии, должности, положению
без разбору	как попало, не выбирая дороги
без сердца	жестокий, бессердечный
без труда не вытащишь и рыбку из пруда	чтобы получить желаемый результат, нужно стараться и прилагать усилия
без труда хлеб не родится никогда	о том, что для достижения желаемого нужно трудиться, прилагать усилия
без ужина подушка в головах вертится	так говорили, когда перед сном не было возможности поесть. очень плохо засыпается, когда ложишься спать голодным
без царя в голове	о взбалмошном, глупом, пустом, неосмотрительном человеке
белый и пушистый	абсолютно невиновный, хороший. часто применяется иронически
благотворительность начинается с дома	cначала помоги своим близким, своей семье, а после помогай другим
близок локоть, да не укусишь	вроде бы близко, легко достигаемо, но на самом деле трудно или невозможно получить
бог (господь) судья	бог всех рассудит
бог милостив	всё обойдется, ничего не случится
богатенький буратино	о богатом человеке (обычно, чье богатство не есть результат его личного труда
богу — богово, а кесарю — кесарево	каждый получает то что ему положено
божий одуванчик	о тихом и слабом, обычно старом человеке
больное место	то, что является причиной постоянных забот, огорчений и переживаний
большой руки	кто-либо обладает какими-либо качествами в высшей степени
бояться собственной тени	психоз
брать к рукам что	брать на себя ответственность за что-либо
брать на испуг, брать на пушку	пугать, часто необоснованно, блефовать
брешут как на мёртвого	ругают напрасно
бровью (глазом) не моргнул	не обнаружил (не обнаружив) никаких признаков волнения, беспокойства, страха
бубнить под нос	говорить очень тихо, невнятно, неслышно
будет и на нашей улице праздник	пожелание удачи и успехов
будь в голубятне корм, а голуби слетятся	люди стремятся в места, где есть необходимые ресурсы и условия
бумага все стерпит	написать можно все, не все то, что написано, может быть сделано
буря в стакане воды	большие волнения по ничтожному поводу
быльём поросло	давно забыто, стёрлось в памяти, безвозвратно прошло
быть большим роялистом, чем сам король	про человека, который проявляет излишнее рвение к чему-либо
быть в фаворе	быть в милости, пользоваться расположением кого-либо
быть запанибрата	быть с кем-либо в коротких отношениях,
быть как во хмелю	нереально воспринимать окружающее
в не лучшей форме	недоделанный, не готовый, испорченный
в голове реденько засеяно	о глупом человеке, который совершенно не хочет думать и задумываться о своих поступках
в интересном положении	о состоянии беременности
в лесу родилась елочка	первая строка популярной новогодней песенки
в ногах правды нет	приглашение присесть, садиться
в пику	в лицо
в пику	с целью досадить
в россии две беды: дураки и дороги	эти слова приписывается русскому писателю гоголю николаю васильевичу (1809 – 1852), но в его произведениях эта фраза не встречается
в рот тебе печёнку	выражения удовлетворения кем-либо
в ружьё	команда, означающая взять оружье и быть готовым к бою
в ружьё	команда: стать в строй с винтовками
в своё время	когда настанет удобное время для совершения какого-либо дела
в силе	кто-либо наделён физической и духовной энергией, работоспособен
в слабой мере	хоть в какой-то степени
в случае чего	если будет необходимость, если случится что-либо нежелательное
в три била били, в пяти мялах мяли	сильно избивали и колотили
в чистом поле	там где нет людей и помощь со стороны маловероятна
валаамова ослица	покорный, молчаливый человек, который неожиданно запротестовал или выразил свое мнение
валять дурака	бездельничать, праздно проводить время
валять дурака	притворяться непонимающим, глупым
валяться в ногах	униженно просить о чём-либо
варфоломеевская ночь	массовое, жестокое избиение беззащитных людей
вбивать гвозди в гробовую крышку мира	уничтожать, разрушать
вверх тормашками	в полном беспорядке, вверх дном
ввести в дело	ввести запасные воинские части в бой
вдалбливать в головы	частым повторением каких-либо мыслей внушать кому-либо определенные взгляды на жизнь
век служил кому	был в услужении у кого-либо в течение долгого времени
великий почин	начало какого-то большого, важного дела
вера, надежда, любовь	верить, надеяться, любить (устойчивое выражение
вербное воскресенье	наименование православного праздника входа господня в иерусалим, который приходится на воскресенье шестой недели великого поста перед светлым пасхальным воскресением и отмечается обрядом освещения вербы
вернемся к нашим баранам	констатация говорящим того, что его отступление от темы разговора окончилось и он возвращается к сути
вернемся к нашим баранам	призыв к говорящему не отвлекаться от основной темы
вернуться к действительности	перейти от мечтаний к реальным делам
вести подпольную работу	проводить какую-либо тайную, противозаконную работу против существующей власти
весёлое дело	по отношению к такой ситуации, которая могла плачевно закончиться
ветер в спину	по отношению к везучим людям
вещи надо принимать всерьез, но никогда трагично	все это очень хорошо звучит в спокойном состоянии, но, когда задышится кровью, как говорят мужики, тогда не до резонов
взять за жабры	взять за ворот, за шею
взять на свои плечи	взять кого-либо на полное содержание
взять перевес	получить преимущество над кем-либо в каком-либо деле
взять хитростью	добиться удачи в бою, применив при этом какой-либо хитрый тактический прием
видна сова по полету	по манере поведения человека можно о нем судить 
власть имущие	о тех, кто стоит у власти.
власть свою показывать	вести себя с кем-либо высокомерно, грубо
влезть в копеечку	потребовать больших затрат
во веки веков	вечно, всегда
во всех отношениях	со всех точек зрения
вода капля за каплей камень точит	если терпеливо и упорно идти вперед и не сдаваться, то достигнешь результата
водой не разольёшь	о крепкой дружбе
вожжа под хвост попала	о том, кто поступает взбалмошно и упрямо
воздушные замки	иллюзии
возмутитель спокойствия	тот, кто ставит неудобные вопросы, тормошит других
вокруг да около	не доходя до сути дела
волк и меченую овечку берёт	волк и меченую овечку берёт
волос ворохнулся	кто-либо сильно смутился, растерялся
волшебное слово	такое чудодейственное магическое слово, которое позволяет выполнить любое желание говорящего
вольная птица	человек, не стеснённый в своих поступках, ни от кого не зависящий, вольный в своих делах и решениях
вольное житьё	чьё-либо поведение, нарушающее супружескую верность
вольный казак	член общины вольных поселенцев, проживавших на окраинах русского государства в xv
ворованное да выпрошенное всегó слаже	ворованное или выпрошенное лучше всего остального
востёр на язык	об остроумном человеке
вот где собака зарыта	вот в чём суть дела!
вот где собака зарыта	вот в чём суть дела, в чём причина
вот тебе, бабушка, и юрьев день	о неожиданно не сбывшихся надеждах, внезапных переменах к худшему
враг моего врага — мой друг	о том, что победить врага легче, если объединиться с врагом своего врага
время лечит	со временем душевная боль притупляется. а потом и вообще проходит 
время разбрасывать камни и время собирать камни	всему свое время
время разбрасывать камни, и время собирать камни	всему свое время
все перемелется, мука будет	когда хотят поддержать и подбодрить в трудную минуту
все совершенное тобой к тебе же вернется	обязательно вернется все, что ты делал в жизни
все хорошо, что хорошо кончается	главное достигнутый результат
всему свое место	по-моему, все очень понятно — во всем должен быть четкий порядок
всему своё время/срок	указание на поспешность события/вывода
всех работ не переработаешь	применяется, когда работы слишком много или для оправдания своей лени, бездеятельности
всосать с молоком матери	усвоить с младенчества
вставлять палки в колеса	сознательно мешать какому-нибудь делу
встать с левой ноги	быть в плохом настроении, раздраженном состоянии
встать с левой ноги	говорится о человеке, находящемся в дурном настроении
встреча без галстуков	встреча политиков или бизнесменов в неформальной обстановке, без соблюдения большинства полагающихся норм протокола
вступать в пререкания с самим собою	про постоянно сомневающегося человека
всяк еремей про себя разумей!	поступай по своему разумению, думай сам
всякой твари по паре	о смешанном, пестром составе какой-нибудь людской группы, толпы, общества
всякому свой живот дорог	каждому дорога его собственная жизнь
втирать очки	обманывать кого-либо, представляя что-либо в выгодном для себя (чаще ложном) освещении
втирать очки	посредством обмана представить кому-нибудь что-нибудь в выгодном, желательном для себя освещении
вторые кочета	крик петухов в 2-3 часа ночи
выбить дурь из головы	образумить кого-либо, заставить кого-либо образумиться
выдавить улыбку	улыбаться через силу, неохотно
выдать головой	предательски выдать
выдать на-гора	предъявить сделанную работу, произвести какую-либо продукцию
вызывать на ковёр / на ковёр вызывать	быть вызванным к начальнику для получения (выслушивания) замечаний
выйти в тираж	прекращение активной деятельности
выкидывать коленца	совершать что-либо неожиданное,необычное, удивительное, интересное
выложить без обиняков	сказать прямо
вынос мозга	об информации, которая удивляет, обескураживает, является неожиданной
вынуть скляночку из души	угодить кому-либо
выставлять напоказ	показывать, обнаруживать, делать что-либо видимым для окружающих
вытрясти отрубя	одержать верх над кем-либо
вытянуться во фронт	стать прямо, сдвинув пятки ног, опустив руки по швам
выходить из себя	терять контроль над своими действиями
выше лесу стоячего, ниже облакого ходячего	о впадании в крайность
вязать инициативу	сковывать чьи-либо действия
гóлому одéться - тóлько подпоясаться	о степени крайней бедности
гвоздь программы/сезона	наилучший номер, наилучший артист в концерте, производящий сенсацию
гений места	в римской религии дух-покровитель того или иного конкретного места (деревни, горы и т.п
гиппократ твердит одно, а галлиен другое	о противоречивости мнений по сложному, спорному вопросу
глаз не казать	не появляться, отсутствовать, перестать где-то появляться
глазам своим не верить	сильно поражаться, удивляться чему-либо увиденному
глас вопиющего в пустыне	не встретить поддержки в своих просьбах
глас народа	общественное мнение
гнать волну	начинать сплетни, толки
говорить без дела, что на воде писать	пустая болтовня трата времени и сил
головы с плеч	убить, казнить
голубая кровь	благородное, высокородное происхождение
голубь мира	изображение голубя как символа мира
горе луковое	о незадачливом, невезучем человеке и неумелом человеке
горе побежденным!	старинное выражение от латинской поговорки
горемычная голова	о вечно тоскующем, грустящем человеке
горы свернуть	совершать великие дела
горький пьяница	неисправимый алкоголик
грехи молодости	плохие поступки, свойственные молодым людям (сомнительные знакомства, бодрствование ночью и т.д
грозный вид	устрашающий вид
гусь лапчатый	о ловком человеке, пройдохе
гусь свинье не товарищ	о совершенно разных и несовместимых людях, которые не могут найти общий язык и дружить
гутарить по чистой	говорить откровенно, начистоту
дай бог	о чем-либо крайне желаемом и необходимом
дали орехов белке, когда у нее зубов не стало	когда необходимая помощь опоздала
дамоклов меч	о постоянно грозящих кому-либо опасностях
дары волхвов	золото как царю, ладан как Богу и благовонные масла как смертному
дары данайцев	коварные дары, приносимые с предательской целью
дать волю кулакам	нанести кому-либо побои, избить кого-либо
дать отвод	отказать кому-либо, выступить против чьей-либо кандидатуры на собрании, на выборах
дать резóн	привести убедительные доказательства для совершения какого-либо дела
дать срок	согласиться подождать некоторое время
два сапога пара	один другого не лучше
два сапога пара	о двух людях, вполне сходных, подходящих друг к другу, в особенности по своим недостаткам
двадцать два несчастья	о человеке, которому катастрофически не везет
девичьи слёзы - что роса на восходе солнца	причина, вызвавшая девичьи слезы, быстро забывается
девичья память	о плохой, "короткой" памяти
дегтем торговать — дегтем и вонять	у каждого дела свои плюсы и свои минусы
дела давно минувших дней, преданья старины глубокой	о событиях из далекого прошлого, с оттенком их маловероятности
дело было к вечеру, делать было нечего	про свободное время
делу время, а потехе час	не стоит увлекаться развлечениями и бездельем
день год кормит	о необходимости ценить каждый день на полевых работах
деньги на бочку	требование расплатиться сразу наличными деньгами
держать на коротком поводке	давать мало свободы
держать под спудом	держать в забвении, в бездействии, в скрытом месте, без применения, употребления
держать себя запанибрата	держаться просто, не важничая, создавая о себе определенное мнение
держать сердце	хранить злобу на кого-либо
держать хвост трубой	никогда не унывать, держаться молодцом
дети, кухня, церковь	виды занятий для правильной женщины
длинная песня	по отношению к утомительному и бесплотному спору
до костей	очень сильно, совсем, насквозь
до кочетов	до полночи, до пения первых петухов в полночь
до положения риз	допьяна
до положения риз	до крайней степени опьянения, до невменяемости
до свадьбы заживет	о небольших ранах, травмах
до третьей тоски	состояние глубокого безделья и ничегонеделанья
дождаться своего	дождаться осуществления чего-либо сильно желаемого
дорожная карта	план действий, мероприятий
досконально знать все тонкости	досконально знать все тонкости
драконовские законы	суровые законы
друга ищи, а найдешь — береги	настоящего верного друга не так уж и просто найти в жизни
дурак быстро расстается со своими деньгами	глупый человек легко теряет деньги
дурак на дураке сидит и дураком погоняет	вокруг одни дураки
дурак учится на своих ошибках, а умный на чужих	если человек видит чужие ошибки и делает из них правильные выводы для себя, то он умный
дуракам закон не писан	человек поступает как ему хочется, даже если это причиняет вред и боль другим
дурным голосом	истошно, истерично
дырка от бублика	о чём-нибудь пустом, лишённом всякого содержания
дёрнул чёрт за язык	кто-либо сказал что-нибудь лишнее
его величество случай	о всесильности не зависящих от человека случайных обстоятельств
его же и монахи приемлют	о вине. в старину эту фразу указывали на бутылках некоторых видов вин
единым духом	очень быстро, мигом
ежовые рукавицы	строгий надзор
езда в незнаемое	поэзия
ем, да свой, а ты рядом постой	если кто-то попрошайничает каждый день, а сам никогда ничем не делится, не вредно дать ему и отпор
если ты такой умный, то почему такой бедный	применяется, чтобы осадить человека, который много умничает, постоянно дает советы, но сам при этом мало чего добился
жатвы много, а делателей мало	одного не достаточно, чтобы исцелить всех нуждающихся
жениться на чужих грехах	жениться на греховной, развратной женщине
жениться никогда не поздно	о том, что жениться можно в любом возрасте
жечь с двух концов свою свечу	иметь возможность позволить себе многое в жизни
житейский опыт	опыт, приходящий с годами, полученный в ходе жизни
жить одним днём	жить сегодняшними заботами, ни о чём другом не думая
жить своим умом	думать самому, соображать своей головой, не полагаясь на чужие советы
жребий брошен	принято окончательное решение, сделан решительный шаг в каком-либо деле
жребий брошен	конец колебаниям, нерешительности (о принятии окончательного решения)
за глаза	в отсутствие кого-либо, заочно
за державу обидно	возмущение тем, что обидели страну (или значимое для говорящего сообщество
за нечаянно бьют отчаянно	предупреждение о том, что случайно совершённый проступок повлечет тяжелые последствия 
за что купил, за то и продаю	что мне сказали, то и передаю (ничего не добавляя от себя) 
забить памороки	лишить воображения
забрить лоб	в дореволюционной россии: взять в солдаты
заветный перстенёк и поношенный хорош	что по-настоящему дорого, в любом виде останется желанным
завидки берут	становится завидно
завязывать концы жизни в узелок	доживать оставшуюся жизнь
загадочная русская душа	загадках, которые задает им природа немецкой души
заговаривать зубы	посторонними разговорами намеренно отвлекать собеседника от какого-либо важного вопроса
закатывать истерики	теряя контроль над собой, вести себя чрезмерно эмоционально
закидать шапками	самонадеянно считать, что можно победить врага без особых усилий
закон парето	чем больше мы делаем для реализации планов, тем меньше получаем
закрой глаза и думай об англии	про неприятные, но необходимые половые контакты (особенно, как совет для женщин, которые не любят своих мужей
закрома родины	богатство, накопления страны
залить горе	выпить спиртное, чтобы успокоиться
замкнуться в себе	сторониться других людей
застала зима сватью в летнем платье	о бедном человеке, у которого нет зимней одежды
затаить злобу	возненавидеть кого-либо
зашел к куме, да засел в тюрьме	неожиданно попал в трудное положение 
зашибать деньги	получать большие деньги
зелёная молодёжь	неопытные и неумелые в каком-либо деле молодые люди
земля людей	о земле как общем человеческом доме (без границ
земля обетованная	место, идеально подходящее для какой-либо деятельности
земля обетованная	место, где царит довольство, изобилие, счастье
земной поклон	до земли, до полу
зимой снега не допросишься	о том, кто очень жаден
змеиное око	степное растение, используемое при лечении укуса гадюки
знать толк	хорошо разбираться в ком- или в чём-либо, быть знатоком в каком-либо деле
знобим стяжанья лихорадкой	о чрезвычайно корыстолюбивом человеке
зол злодей, а ты позлей злодея окажись	призыв быть циничным и безжалостным
золотая молодёжь	дети богатых родителей
золотое рукопожатие	щедрое выходное пособие работнику, применяемое обычно для того, чтобы подтолкнуть к раннему уходу на пенсию
и близко не родня!	кто-либо уступает кому-либо другому по каким-либо качествам (при сравнении двух разных людей
и в мыслях не держал	даже не думал поступить определеным образом
и конца не будет	о чём-либо бесконечно продолжающемся
и нашим и вашим	угодить всем
и сел бы, и съел бы, кабы в гости позвали	о человеке, который любит и всегда готов получать все за чужой счет
и следа не было	о полном исчезновении кого-либо или чего-либо
и так, и перетак, и разэтак	употребляется как эвфемизм (смягчающее обозначение) вместо бранных, неприличных слов
и ухом не повел	не отреагировал
и шилом не выковыряешь	ни за что не оторвёшь от какого-либо дела
играть в кошки-мышки	соревноваться с заведомо неравными партнерами
играть в похоронки	скрываться, прятаться
идти в гору	добиваться всё более высокого положения в обществе, в жизни
идти на поводу у кого-л	постоянно слушаться чьих-то советов, указаний, просьб
идти на пользу	оказывать положительное действие, давать хороший результат
из двух зол предпочесть меньше	из двух нежелательных ситуаций следует выбрать ту, которая имеет меньше последствий
из-под земли достать	найти, несмотря на все трудности
изводишь единого слова ради тысячи тонн словесной руды	о поэзии
изо дня в день	ежедневно, постоянно
именины сердца	радость, приятное событие
именья - одни каменья	о полной бедности у кого-либо
инженеры человеческих душ	о писателях
исайя ликуй	поздравление с победой, торжеством, кого-либо
искры из глаз посыпались	о действии оглушающего, сильного удара
искусство для искусства	про произведения искусства, которые понятны только профессионалам и непонятны, неинтересны широкой массе
исчадие ада	о ком-нибудь, кто внушает отвращение, ужас своим видом, действиями
каждый комик мечтает о гамлете	о том, что каждый актер желает сыграть значительную роль
каждый суслик в поле – агроном	о людях со малым знанием и опытом, но которые считают себя большими экспертами в чем-либо и это открыто заявляют
казённый лес	государственный лес
как баран на новые ворота смотреть	смотреть тупо, с недоумением, ничего не понимая
как в стенке	твёрдо, непоколебимо
как водой снесло	о вещи, которая незаметно пропала и ее невозможно найти
как за каменной стеной	под надёжной защитой
как из цыгана поп	по отношению к тем, кто неспособен к какому-либо роду деятельности
как кошка с собакой	в крайне неприязненных отношениях
как мертвому припарки	бесполезно, попусту
как ни в чём ни бывало	не замечая того, что произошло, что происходит вокруг
как ни крутись	что ни делай, как ни рассчитывай, но не миновать того, что предначертано
как пить дать	обязательно, непременно
как хотите	как бы вам не хотелось
каких свет не видывал	по отношению к тому, кто выделяется среди других людей своими отрицательными качествами
кануть в лету	быть навечно забытым, преданным забвению, о событиях, фактах, воспоминаниях
карточный домик	о чём-нибудь очень непрочном, ненадёжном
кататься как сыр в масле	жить в полном довольстве, достатке
каша из топора	пища, приготовленная на скорую руку, из тех продуктов, что были в наличии
квасной патриотизм	ложно принимаемая любовь к отечеству, огульное восхваление всего своего и порицание чужого
квелить душу	терзать душу
кишка тонка	не хватает (не хватит) сил, способностей на что-нибудь
кишмя кишит	о множестве беспорядочно движущихся живых существ: людей, животных, рыб, насекомых и пр
кишмя кишит	о сплошной массе
класть зубы на полку	испытывая нужду, ограничивать себя в самом необходимом, голодать
клин клином вышибать (выгонять	подобное побеждается подобным
клясться отцом-матерью	клятвенно заверять кого-либо
кнут и пряник	метод поощрений и наказаний
когда будем помирать, тогда будем горевать	о необходимости жить полной жизнью, наполняя ее радостью, весельем, удовольствием
когда не умеют писать, говорят, что перо плохое	кто всегда обвиняет других людей или обстоятельства в своих личных неудачах
козел отпущения	о человеке, которого сделали единственным виноватым, за тот проступок, который совершили несколько людей
козья тропа	труднопроходимая тропинка в горах
колесо фортуны	слепая судьба, превратности, непостоянство человеческого счастья
коллежский советник	гражданский чин vi класса в табели о рангах. соответствовал чинам армейского полковника и флотского капитана i ранга
комок нервов	нервный человек
кому война, а кому мать родна	о тех, кто наживается на войне
концы в воду	скрыты все следы (о чем-нибудь неблаговидном
концы с концами сводить	справляться с трудом с нуждами, расходами
конченое дело	о чём-либо безнадёжном, закончившимся провалом
копейка рубль бережет	о бережливости: экономя понемногу можно сэкономить приличную сумму (буквально — экономя по копеечке можно сэкономить рубль
корчить из себя	изображать из себя
косить от армии	уклоняться от армейской службы
краеугольный камень	основание, фундамент чего-либо
кровь из носу	употребляется здесь как угроза: изобью до крови
крутить быкам хвосты	ухаживать за домашним скотом
кто живет в памяти своих близких, тот не умер	немецкая пословица
кто законы пишет, тот их и ломает	о недоверии народа к тем, кто пишет законы, оставляя лазейки для себя
кто рано встает тому бог дает	кто рано встает, тот много и раньше других успевает
курам на смех	о смешно выглядящем человеке, или каком-то нелепом поступке, который заставит смеяться даже кур, не умеющих смеяться
курить фимиам	восхвалять
курочка по зернышку клюет и сыта бывает	богатство (состояние) накапливается и через небольшие, но регулярные сбережения
кусать локоток	сожалеть, досадовать о непоправимом, упущенном, потерянном
лебединая песня	заключительный этап процесса
лежачего не бьют	побежденного не добивают
лезть на рожон	предпринимать что-нибудь заведомо рискованное, обреченное на неудачу
лень вперёд родилась	о крайне ленивом человеке
лес рубят - щепки летят	в любом деле бывают издержки
лить колокола	врать, распускать небылицы,сплетни
лихие 90-е	период с 1991 по 1999 годы в россии, когда царствовали беззаконие и дикий капитализм
лицом в грязь не ударить	удачно сделать что-нибудь, показав себя с лучшей стороны
лишение огня и воды	изгнание, один из видов наказаний
ломать работёнку	усердно работать
лучшая половина	женщины (лучшая половина человечества
любил медок, люби и холодок	терпи 
любо - дорого	приятно, интересно
люди в белых халатах	врачи
лёгкая рысь	спокойная, тихая рысь
лёгкие хлеба	деньги, зарабатываемые легкой работой
мал золотник, да дорог	ценность небольшого, простого, неприметного, но очень важного
мал клоп да вонюч	даже мелочи могут причинить большие неприятности
медвежья услуга	неумелая, неловкая услуга, приносящая вместо помощи вред, неприятность
мелкие как бисер	очень мелкие
мелким бесом рассыпаться	ловко, угодливо льстить кому-нибудь, заискивать перед кем-нибудь
менять как перчатки	часто менять
мертвые сраму не имут	обращение к своим воинам перед сражением
минимум миниморум	очень мало (минимальное значение из возможных
министр без портфеля	член правительства, который не руководит министерством, а выполняет отдельные поручения премьер-министра
мир не без добрых людей	о людях, которые оказали помощь 
млечный шлях	звездное скопление в виде светлой полосы на темном небосклоне
мои университеты	школа жизни. то, что существенно повлияло на развитие человека
молод годами, да стар умом	о человеке, который не смотря на свой юный возраст, очень умный и мудрый в мыслях и поступках
молодость — пташкой, а старость — черепашкой	в молодости много сил и энергии, а в старости сила и энергия уменьшаются
молчаливое большинство	избиратели, которые не выражают свое мнение через демонстрации, марши и т.д
молчи, грусть, молчи!	не стоит грустить
момент истины	момент, когда правда становится очевидной
муж, не серди свою жену	фраза, которую наносили на столовую посуду, предметы интерьера в 19 веке – начале 20 веков
мужчинское дело	физическая работа, требующая больших физических затрат
мурло наесть	отъесться
мухи не обидит	совершенно безобидный
мышь копны не боится	не страшно то, с чем хорошо знаком
мягкотелый интеллигент	бесхарактерный интеллигент
нóвая жизнь	жизнь в замужестве
на «ты»	очень хорошо разбирающийся в вопросе
на бобах сидеть	остаться не при чем, обмануться в ожиданиях
на вес золота	о чем-либо очень ценном, крайне нужном и очень дорогом
на воре шапка горит	нередко украл тот, кто больше всего кричит о воровстве 
на глаз	приблизительно, примерно
на грани фола	в условиях близких к нарушению установленных правил
на деревню дедушке	по заведомо неполному, неточному адресу
на душе кошки скребутся	человек находится в очень тяжелом состоянии, чувство обиды, переживания, стыда за свой поступок
на карачках	на четвереньках
на кнут да махнуть	о малом количестве чего-либо
на кой ляд	зачем?, для чего?, к чему?
на обухе рожь молотит	про бережливого или скупого человека
на огонек зайти	к кому зайти к кому-нибудь ненадолго
на пече, да в горячем просе	о желании получить что-либо, не приложив собственных усилий, не ударив при этом палец о палец
на плечах	на содержании
на повышенных тонах	громко, раздражённо
на последнем издыхании	из последних сил
на птичьих правах	говорится о ком-нибудь, пользующемся чем-нибудь случайно, не имея прочных оснований, положения
на роду написано	суждено, предопределено
на словáх	устно
на холостом ходу	бесполезно, бессмысленно
на худой конец	в крайнем случае, в случае неблагоприятного развития событий
на чужого дядю работать	работать по найму (по трудовому договору с работодателем
на чужой рот пуговицы не нашьешь	людям не запретишь говорить (особенно про распространение слухов) 
на широкую ногу	богато, роскошно, не считаясь с затратами
набралось гостей со всех волостей	неожиданно встретили большую группу людей 
навести чистоту	сделать уборку
надёжные руки	верные и преданные люди
найти железку	обнаружить, отыскать что-либо пустое, ненужное, что вызывает смех, насмешку
наклеивать ярлыки	приписывать кому-нибудь или чему-нибудь какие-либо свойства, качества, исходя из принятых стандартов, определенных шаблонов.
налетел с ковшом на брагу	про человека, пристающего к другому с претензиями, расспросами, разговорами
наложить на себя руки	покончить жизнь самоубийством
направить лыжи	уйти, уехать, отправиться в каком-либо направлении
напрашиваться на неприятности	сознательно создавать себе неприятности, вмешиваться в неприятную ситуацию без нужды
народиться на свет заново	почувствовать себя необыкновенно хорошо
насильно мил не будешь	как не старайся, а если ты или твои дела, предложения, или слова не нравятся другим, то ты никогда этим людям не угодишь, не будешь нравиться, или с тобой не будут иметь дело
наш пострел везде поспел	про молодого и проворного человека
наша взяла	выражение признания чьей-либо победы или успеха в каком-либо деле
наша миссия — комиссия	о брокерах, риэлтерах, посредниках, которые действуют не в интересах клиентов, а для личного обогащения
не без опáски	опасаясь чего-либо
не будить! не кантовать! при пожаре выносить первым!	право отдыхать, когда другие работают
не бывает некрасивых женщин, бывает мало водки	о том, что в состоянии опьянения мужчина меньше обращает внимание на недостатки женщины
не в дóбрый час	не в подходящее время, не вовремя
не в деньгах счастье	деньги хоть и важная составляющая успеха и счастья, но далеко не единственная
не в коня корм	когда человек не может понять какую-то информацию, какую-то науку, то есть ему не хватает сообразительности
не в службу, а в дружбу	не по обязанности, а из дружеского расположения
не в тягость	что-либо дается легко, особенно не обременяет
не в укóр	не для того, чтобы обвинить кого-либо в чём-либо
не везет в картах, повезет в любви	кому не везет в карты, тому может повезти в любви
не видеть дальше своего носа	об ограниченности, узости кругозора
не всякий прут по закону гнут	иногда для достижения результата необходимо нарушить закон
не выпустить из рук	держать кого-либо под контролем
не давáть покóю	без конца беспокоить кого-либо
не дай и не приведи госпóдь	о недовольстве своей жизнью
не дать в обиду	не позволить обидеть кого-либо, заступиться за кого-либо, не позволить причинить ущерб, неприятность кому-либо
не для знаний, а для звания	о человеке, который пошел учиться, чтобы получить диплом, но сами знания его мало интересуют
не за горами	скоро, близко (о времени
не иметь выбора	быть вынужденным поступить именно так
не купи двора, купи соседа	о важности того, чтобы соседи были хорошими
не лыком шит	не так прост, как кажется
не на такую напался	выражение означающее: недооцениваешь того, с кем имеешь дело
не надо лохматить бабушку	не надо обманывать 
не нынче - так зáвтра	о том, что вот-вот должно произойти, наступить
не от слáдкой жизни	по крайней необходимости
не по пути	разойтись с кем-либо во мнениях и в делах
не подавáть виду	держаться внешне спокойно, не показывая своего внутреннего переживания
не пойман — не вор!	если нет явных доказательств вины другого человека, то нельзя считать его преступником
не поминайте лихом	не вспоминайте обо мне плохо (говорится при расставании
не попробуешь – не узнаешь	только попробовав что-либо, можно это познать
не путём	зря, напрасно
не рóвен час	вполне возможно, пожалуй
не родись умен, не родись пригож, а родись счастлив	важнее быть счастливым, чем красивым 
не рой другому яму, сам в неё ввалишься	зло, которое творится без причины по отношению к другому человеку, обязательно вернется в два раза больше
не руби сук, на котором сидишь	пословицу говорят, когда человек сам своими действиями или словами может навредить себе
не с чем	не имея достаточное количество чего-либо
не свои и не чужие	о состоянии неопределенности при размолвке между близкими людьми
не своим голосом	исступлённо, неистово
не сдвинешь с места	по отношению к человеку с принципиальными взглядами на жизнь
не смежить глаз	совсем не спать всю ночь, находиться в состоянии бодрствования
не спеши языком, торопись делом	не стоит заранее говорить, или хвастаться о чем-либо. сначала сделай дело, а потом уже рассказывай о том что сделал
не то слово	восклицание, означающее высшую степень похвалы
не трусь. солдат ребенка не обидит	человек, который напугал своим появлением другого
небо в алмазах	то, что кто-либо страстно желает, восторженное настроение у кого-либо
ненадолго лягушке хвост	о чём либо быстро закончившемся
неотъемлемая часть	обязательная часть
несолоно хлебавши	обманувшись в своих ожиданиях, не добившись желаемого, встретив плохой прием
нести свой крест	идти к цели, преодолевая страдания и испытания
нет леса без волка, нет села без злодея	среди людей не бывает только хороших, обязательно есть плохие
нет худа без добра	в любом плохом событии, как правило, есть что-то положительное, полезное
нету нужды	нет никакой необходимости что-либо делать
нечистый попутал	кто-либо поддался соблазну, искушению сделать что-либо нежелательное (обычно предосудительное
ни богу свечка, ни черту кочерга	о чём-нибудь никчёмном: так себе, ни то, ни сё
ни в зуб ногóй	абсолютно не разбираться в чём-либо
ни в чох ни в сон ни в птичий грай	не верить в приметы, в чудеса
ни за понюшку табаку	совершенно напрасно, ни за что
ни пава, ни ворона	о том, кто отбился от одних и не пристал к другим
ни туда ни сюда	никуда
ни чертá не приметить	ничего не заметить
ни шáтко ни вáлко	посредственно
низко клáняться	передавать привет
низкого пошиба	о ком-чем-либо плохом, невысокого качества, достойном осуждения
ничего особенного	что-либо обычное
ночная кукушка дневную перекукует	сын будет на стороне жены, в случае конфликта жены с его матерью
ночь длинных ножей	переворот, осуществленный с массовыми убийствами людей
ну что, брат пушкин?	намека на то, что собеседник заврался
нужен, как собаке пятая нога	лишний, ненужный, мешающий
обжегшийся на молоке, дует и на воду	кто ошибся или потерпел неудачу, становится осторожным и предусмотрительным во всех делах
обжечь взглядом	выразить свою ненависть, злобу, обиду
оборвáть смех	прервать смех, прекратить смеяться
обычная вещь	то, что является повседневной реальностью
овладеть собóй	успокоиться, взять себя в руки
овчинка выделки не стоит	о пустяковом деле, которое потребует больше сил, чем принесет результата
огорошить неожиданностью	сильно удивить, озадачить кого-либо
один в поле не воин	когда люди помогают друг другу, то им легче справиться с делом, врагом или трудностью, чем одному
один глаз на нас, другой на арзамас	о человеке, страдающем косоглазием
один как сыч	одинокий человек
одного поля ягоды	равноправны
оказаться в нужное время, в нужном месте	счастливый случай помог в деле потому, что вы находились именно в этом месте
опять за рыбу деньги	опять то же самое, опять одно и то же (о чем-либо постоянно, систематически, неизменно повторяющемся
осóбый отдел	военный орган контрразведки
осведомленность порождает презрение	человек слишком часто сталкивается с кем-либо или чем-либо, то он настолько хорошо становится осведомленным обо всех ошибках, недостатках, что начинает презирать этого человека или явление
остáвить в живых	сохранить кому-либо жизнь
остáться с разбитым корытом	неудачно завершить, провалить какое-либо дело
оставить без внимания	пренебречь чем-либо
от ворот поворот	выпроводить вон, предложить уйти
от забора и до обеда	о неопределенном времени в течение которого нужно работать
от зари до зóрьки	всю ночь, с вечера до утра
от каждого — по способностям, каждому — по труду	от каждого человек требуется его участие в общественных делах исходя из его способностей, а потреблять человек может исходя из его трудового вклада
от тюрьмы и от сумы не зарекайся	в жизни все возможно (обычно, о плохом)
отдавать честь	приветствовать приложив руку к головному убору
отживший человек	человек, уже не способный от старости на какое-либо существенное дело
отогреть змею на груди	проявлять внимание, заботу, любовь к человеку, который впоследствии платит неблагодарностью
отставной козы барабанщик	о человеке малозначительном, не имеющем никакой должности или утратившем её
отца родного не пожалеет	по отношению к принципиальному человеку, отстаивающему свои взгляды до конца
очи черные, очи страстные!	о красивых глазах черного цвета
пальма первенства	символ победы, высшей славы
панургово стадо	толпа, идущая безрассудно за своим вожаком, бессмысленные подражатели (от имени панурга, героя романа французского писателя 16 в. рабле "пантагрюэль"
пенни умный и фунт глупый	про людей, которые очень аккуратны с незначительными делами, но беспечны с важными
первая любовь	самое первое и глубокое чувство любви в жизни человека
перво - нáперво	в первую очередь, вначале
первый встречный	случайный человек
первый среди равных	выдающийся, главный, ведущий, самый лучший
передний край	место непосредственного соприкосновения с противником
перейти через рубикон	совершить действие с заведомо необратимыми последствиями
перековать мечи на орала	перестроиться с военного на мирный лад
переть ересь	говорить чушь, ерунду
пилотный проект	экспериментальный проект
плести лапти	путать что-либо в деле
плох тот солдат, который не мечтает стать генералом	хорошо, когда человек стремиться к лучшему, к большему, стремиться быть лучшим в своем деле
по газонам не ходить	предупреждающая надпись у травяных покрытий
по прáву	по закону
по себе людей не судят	о том, что не нужно судить о людях исходя из своего отношения к чему-либо
побежденные всегда неправы	французская поговорка
погнуть до корня	полностью, основательно изменить кого-либо
погрязнуть в рутине	погрязнуть в рутине
под гребёнку стричь	коротко стричь волосы
под ложечкой	в нижней части груди, под рёбрами
подлецу все к лицу	красивому, обаятельному человеку идет любая одежда
подложить свинью	устроить неприятность
поднять дух	улучшить настроение, укрепить боевой дух, настроить на активную деятельность
подобрáть ключик	завоевать чьё-либо расположение
подчиниться сердцу	поступить по совести
подымáть голову	начинать враждебные действия против кого-либо
пожáть плечáми	выразить удивление, недоумение, засомневаться в чем-либо
познай самого себя	каждый должен изучить самого себя, чтобы понять смысл жизни, выработать правильное отношение к ней (заповедь дельфийского оракула
покатиться со смеху	громко, безудержно смеяться, расхохотаться
поклониться в ноги	повиниться, попросить прощения
ползти как улитка	ползти как улитка
ползти по-пластунски	ползти на локтях, не отрывая тело от земли
положить глаз	заинтересоваться
положить зубы на полку	трудности с деньгами, быть бедным
положить поклон	поклониться
получить на орехи	получить на орехи
помирать, так с музыкой	была не была, нечего бояться, надо рисковать 
понести потери	иметь убитых и раненых среди личного состава подразделения
попáсть в переплёт	оказаться в трудном, опасном или неприятном положении
попáсть на своего конькá	с большим увлечением говорить, рассказывать о каком-либо интересующем деле
попасть пальцем в небо	сказать невпопад, сделать грубую ошибку
попахивать неприятностями	попахивать неприятностями
порá и честь знать	настало время прекратить что-либо
пороху не нюхали	неопытные, необстрелянные бойцы, только прибывшие на боевые позиции
порядок бьет класс	слаженное, грамотное взаимодействие команды важнее индивидуального мастерства игроков
после нас хоть потоп	лишь бы нам было хорошо
последнее китайское предупреждение	предупреждение, являющееся последним только на словах
последний из могикан	последний из известного рода людей-деятелей, героев
последнюю копейку отдать	истратить последние деньги
последняя/высшая инстанция	человек, который принимает окончательное решение
постáвить вопрос ребром	решительно и категорично поставить кого-либо перед решающим выбором
поставить на вид	сделать предупредительное замечание о каком-нибудь упущении
поставить точки над и	уточнять, не оставляя ничего недосказанным
постоять за себя	защититься
посылать к чёрту всё и вся	полностью пренебрегать мнением других людей, относиться ко всем остальным с полнейшим пренебрежением
потерять из виду	перестать видеть кого-либо
потерять счёт	сбиться со счета
потом и кровью	величайшими усилиями, с большим трудом
пошёл чертить на месяц	кто-либо сильно запил
прáвда - мáтка	истинная, сущая правда
правда глаза колет	правду неприятно слышать
прекрасное далёко	о спокойном пребывании вдали от жизненных невзгод, борьбы
препоясать чресла	приготовиться к странствованию
прийти в голову	появляться, возникать (о плане, намерении, мысли
прийти к мысли	принять какое-то решение
прийтись не ко двору	прийтись не ко двору
прикинуться сиротой	показать себя несчастным
прильнуть к губам	поцеловать
принимáть бой	отражая наступление войск противника, вступить с ним в сражение
принцесса на горошине	о том, кто чересчур привередлив, чувствителен к неудобствам
принять лиха	настрадаться, помучиться
припомнить обиды	рассчитаться с кем-либо за прошлое
притча во языцех	предмет всеобщих разговоров, постоянных пересудов
продать себя	по отношению к женщине: вступить в интимную близость с кем-либо из-за денег
пройти огни и воды, и медные трубы	многое испытать в жизни, побывать в различных трудных положениях, переделках, приобрести при этом большой жизненный опыт
прокрустово ложе	мерка, под которую стремятся насильственно подогнать, приспособить то, что не подходит под нее
пропускать мимо ушей	игнорировать какую-либо информацию, чьи-либо замечания
просить добром	стараться по-хорошему разрешить какой-либо вопрос, чтобы не иметь тяжёлых последствий
просто и блохá не кусáет, а с умыслом	просто так ничего не делается
пруд пруди	большое количество
прямо сорока летает	тот кто живет правдиво, сталкивается с трудностями
пуп земли	о самоуверенном человеке
пускать пыль в глаза	хвастаясь, щеголяя мнимыми достоинствами, обманывать, морочить
пусть небеса свершат правосудие	автором цитаты считается луций кальпурний пизон цезонин — консул древнего рима 58 года до н. э
путь наименьшего сопротивления	тактика поведения, требующая приложения минимальных усилий
пьяному и море по колено	пьяный человек переоценивает свои возможности
рада бы маша за попа, да поп не берет	человек желает, но не может получить
ради бога	пожалуйста, очень прошу: употребляется либо при выражении какой-либо просьбы, либо при выражении полнейшего согласия с чем-либо
развязáть морской узел	решить какой-либо болезненный вопрос
раздача слонов	вручение подарков, гостинцев и т.п.
разлука заставляет сердца любить нежнее	недолгая разлука освежает романтические чувства влюбленных
разобрáть всё по косточкам	рассмотреть какое-либо дело подробно, обстоятельно, до мелочей
разрубить гордиев узел	избавиться от проблемы самым решительным путем
разрубить гордиев узел	разрешить затруднения насильственным, прямолинейным способом
расписывать чортовую	возражать, не соглашаться с кем-либо, приводя этим в сильное раздражение своего собеседника
распустить хвост	хвастаться, показывать себя с выгодной стороны
рассыпаться прахом	закончиться ничем
резала коса, да нарезалась	так говорят про того, кому сначала все сходило с рук, но потом все изменилось в худшую для него сторону 
резать ухо	неприятно на слух
ренсковый погреб	винный магазин
решать проблемы по мере поступления	призыв решать проблемы (задачи) тогда, когда они действительно наступят
риск — благородной дело	пословицу говорят, когда хотят оправдать риск в каком-то деле. очень часто, чтобы добиться успеха, нужно идти на риск
родимец тебя возьми	выражение досады, изумления, огорчения, недовольства, раздражения
родиться в сорочке	о человеке, который чудом остался в живых
рука руку моет	о тех, кто прикрывает неблаговидные дела друг друга
руки уверх	приказ кому-либо поднять руки с целью лишить возможности оказать сопротивление
русский человек задним умом крепок	о непредусмотрительном, поздно спохватывающемся человеке 
рыльце в пуху	очевидная причастность к какому-то нехорошему делу
с глáзу на глаз	наедине
с лёту	без заминки, моментально
с маху	быстро, не раздумывая
с места в карьер	сразу, без всяких приготовлений
с миру по нитке — голому рубаха	собирая со всех понемногу, можно набрать крупную сумму денег
с плеч долой	об освобождении от каких-либо забот, обязанностей
с плеч долой	не надо больше думать, беспокоиться, обременять себя чем-либо
с пылу	прямо с печи (о чем-либо горячем, снятом с огня
с рук сойти	остаться безнаказанным
с той поры	с того времени
сáдная боль	нестерпимая, ноющая боль
сáдная боль	нравственные переживания
садиться не в свои сани	браться не за свое дело, заниматься тем, на что не способен, на что нет достаточных знаний, нужной подготовки
сады семирамиды	что-то роскошное
сажать в калошу	ставить кого-либо в неловкое, нелепое, смешное положение
сажать в холодную	сажать под арест
сам не свой	сильно взволнован, расстроен
сам тетерев, а хочет выглядеть павлином	о человеке, который носит одежду не своего стиля, которая ему не подходит
сам себе голова	совершенно независимый, самостоятельный человек, который волен поступать так, как ему захочется
сами с усами	сами, сам не хуже, не глупее других
самурай должен быть готов сразиться с семью врагами	нужно всегда быть готовым к борьбе с препятствиями, врагами
сбиться с путей	потерять нравственные ориентиры в жизни
сбоку припёка	по отношению к кому-либо или чему-либо лишнему, ненужному
сбор пресвятой богородицы	очень разнородный состав людей
свадебный генерал	подставное лицо (приглашенное лишь для представительства), обладающее мнимым авторитетом и не играющее никакой роли в каком-либо деле
светлая голова	светлая голова
свинья грязь везде найдёт	о том, кто всегда найдёт себе подходящую компанию
свобода одного человека заканчивается там, где начинается свобода другого	принцип человеческого общежития, который предполагает, что человек волен делать то, что пожелает, но так, чтобы не нарушить свободу других людей
своя земля и в горести мила	дома хорошо и приятно всегда
сдать оружие	перестать сопротивляться и сдаться в плен
сделать ку	выразить кому-либо почтение, граничащее с раболепством
северная пальмира	образное название Санкт-Петербурга
седьмая вода на киселе	о человеке, находящемся в крайне отдаленном родстве с кем-либо
семен семенович	применяется с укором к тому, кто совершил явную оплошность
семена раздора (посеять	зародить вражду между кем-либо
семеро по лáвкам	о многочисленном семействе у кого-либо, нуждавшееся в заботе
сердечные делишки	о чём-либо, связанном с сердечными чувствами, переживаниями
сердце замерло	кого-либо охватывает радостное волнение
сердце застучáло	о неприятном состоянии, вызванном каким-либо переживанием
сердце зашлось	стало больно в груди
сердце не лежит	что-то не нравится
сжать губы	выразить чувство сильного волнение
сидеть как на угольях	чувствовать себя очень неуютно
сильный победит одного, знающий — тысячу	с помощью знаний и науки любое дело будет гораздо эффективнее и лучше
сиротинка - кáпля	последняя капля спиртного в посуде
сиять как медный грош	быть счастливым, светиться от радости
скачи, враже, як пан каже	беги враг, куда тебе сказали
скидываться на что-либо	скидываться на что-либо
скинуть с плеч	помолодеть
скоблить службу	воевать, испытывая все тяжести войны
скорее скорого не сделаешь	быстрее сделать не получится
скоро сказка сказывается, да не скоро дело делается	употребляется как присказка (к сказке, рассказу
скрепя сердцем	применяется, когда делается какое-то дело против воли, когда делать его не желаешь, но нужно или заставляют обстоятельства
скупой на слова	молчаливый при общении
скупой платит дважды	человек, который принимает решение только исходя из дешевизны, в итоге вынужден платить больше
слаб умом	неумный, глупый
слава герострата	слава вандала, разрушителя (по имени грека герострата, который, по преданию, сжег храм богини артемиды в эфесе, желая прославить свое имя
сладкое бремя славы	о славе
слепое орудие	человек, слепо выполняющий волю других людей
сливки общества	элита
словно кипятком ошпáренный	будучи в сильном волнении
слон в посудной лавке	о большом и нескладном человеке, оказавшемся в тесноте, среди ломких, хрупких вещей
слышал звон, да не знает, где он	знать дело, только частью, не совсем, — смутно
смáтывать удочки	убегать, исчезать
смертный грех	самый тяжёлый грех, непростительный поступок
смерть за плечьми висела	кто-либо был близок к смерти
смешно сказать	даже не верится
смотреть правде в глаза	принимать истинное положение дел
сначала стреляй, а потом задавай вопросы	в защиту агрессию
снявши голову по волосам не плачут	не стоит горевать о небольших неприятностях, когда стряслось большое горе. этим дело не поправишь
собáке - собáчья смерть	о смерти врага или ненавистного человека
собáчья бесила	дурман обыкновенный
совесть не позволит	будет стыдно совершить какое-либо недостойное дело
содом и гоморра	употребляется для обозначения распущенности, крайнего беспорядка, шума, суматохи
сор из избы выносить	сор из избы выносить
сорвать	выиграть все деньги, находившиеся в банке
сорок потов сойдут	о сильной усталости после тяжелой работы
сосуд скудельный	о человеке как слабом, бренном существе
спаси себя и хватит с тебя	нужно заниматься собой, а не лезть к остальным с советами, если тебя не просят
ссора в семье до первого взгляда	если люди любят и уважают друг друга, то когда они взглянут в глаза друг другу, то скорее всего остынут, улыбнутся и помирятся
стáрость - печáль	у старого человека много трудно решаемых проблем
ставить себе за правило	сделать своим правилом
стакан наполовину полон (стакан на половину пуст	простой тест, позволяющий определить, является человек оптимистом или пессимистом
старый конь борозды не портит	опытный, хотя и немолодой человек, все сделает правильно, благодаря своему опыту
стать на одном	не отступить от своих убеждений
стеречь пуще зеницы ока	очень заботливо, надёжно, тщательно оберегать
стерпится — слюбится	когда люди вынуждены жить под одной крышей, то со временем приходит чувство любви или дружбы друг к другу
стоять в стороне	занимать выжидательную позицию, наблюдая со стороны за развитием событий
стоять стеной	стоять, тесно сгрудившись
страдания юного вертера	любовные страдания, муки неразделенной любви
строг, но справедлив	оправдание чересчур неумеренной взыскательности
стукнуть в лоб	сильно подействовать
судный день	суд над людьми при наступлении конца мира, света
суета сует и всяческая суета	о мелочных заботах, о чем-либо ничтожном, бесполезном, не имеющем истинной ценности
сукин сын	выражает недовольство, негодование, раздражение, злобу говорящего
сутки напролёт	ежедневно, изо дня в день
сучье вымя	собачье отродье
считать ворон	быть рассеянным, невнимательным, несосредоточенным на нужном
счёт потерять	не иметь возможности сосчитать кого-, что-либо из-за большого количества
сшибить лишнюю копейку	заработать
сыт по горло	нежелание продолжать
сытый голодного не разумеет	человек, у которого все хорошо (все проблемы решены), может не понимать поведения того, который нуждается (у кого есть проблемы
тайны мадридского двора	об интригах, секретах вышестоящих лиц, непонятных их подчиненным
таких поискáть	самый лучший из всех по своим качествам и достоинствам
тамбовский волк тебе товарищ	недружелюбие
танцевать от печки	начинать с привычного, уметь делать что-нибудь только по привычному шаблону
таять как свечка	худеть в результате страданий и переживаний
тернистый путь	трудный, тяжкий жизненный путь
тили-тили-тесто, жених и невеста!	детская дразнилка, которую говорят (кричат), если мальчик и девочка дружат или идут вместе
типун на язык	выражение недовольства по поводу сказанного
тихая жизнь	спокойная, семейная жизнь
тихий как девка	скромный, застенчивый молодой человек
тонкий намек на толстые обстоятельства	о весьма прозрачном намеке (намек на слово: "тонкое обстоятельство") (большой толково-фразеологический словарь (1904 г.) михельсона м. и
торопилась девка зáмуж выйти, а женихá не оказáлось	торопливость, нередко, приводит к потере времени из-за нежелательных происшествий
третья часть мерлезонского балета	о продолжении либо повторении какого-либо слишком затянувшегося и утомительного действа
трудности перевода	о трудностях в понимании традиций, обычаев, привычек, мировоззрения других народов, социальных групп
трястись от смеха	очень сильно смеяться, дергаясь при этом всем телом
ты все пела?	о незаботливом, незапасливом
тютелька в тютельку	абсолютно точно
тёмная история (дело	непонятное и необъяснимое дело, вызывающее подозрения
тёмно на сердце	тяжело, безрадостно на душе
тёмные люди	малограмотные люди, плохо разбирающиеся в окружающей ситуации
у страха глаза велики	трусу везде страшно, везде видится опасность
убей на месте	клятвенное заверение в решимости совершить какое-либо дело
убийцы в белых халатах	фраза из публикаций в прессе о так называемом "деле врачей", в результате которого много невинных врачей было осуждено
ужасный край чудес	кавказ
уйти по-английски	уйти не прощаясь
умá много нажить	по отношению к людям, которые много говорят, показывая себя умными и сведующими в жизни, но мало приносят пользы
ума палата	очень умён
умный в гору не пойдет, умный гору обойдет	умный человек найдет самое правильное и эффективное решение ситуации
умный женится, а дура замуж идет	о ситуации, когда будущий муж получает больше выгоды от женитьбы, чем жена
уму - разуму учить	учить кого-либо как следует поступать, как следует жить
умывать руки	отказываться от продолжения участия в каком-то деле
унеслá нелёгкая	пронесло: не состоялась нежелательная встреча
утечка мозгов	утечка мозгов
утка - шептун	особая порода крупной домашней утки, издающей не крякающий, а шипящий звук
федот, да не тот	не то чем представлялось в начале
философский камень	начало всех начал, основа всего сущего
филькина грамота	о пустой, ничего не стоящей бумаге, не имеющем никакой силы документе
что за фря	возглас презрительного возмущения по поводу чьего-либо капризного поведения
хит парад	список наиболее популярных вещей, музыкальных произведений, людей и т.д
ходить в девках	быть незамужней
ходить как в воду опущенный	потерять настроение, всякий интерес к жизни
ходить по ниточке	быть хорошо вышколенным, послушным
хозяин – барин	в твоих силах сделать это
хорошая одежда ума не прибавит	умные люди будут оценивать тебя за твой ум и твои поступки
хотел дед вареников попробовать, а собáка творог съела	о чем-либо сильно желанном, но не осуществившемся
хотите верьте хотите нет	информация к размышлению
хоть волков морозь	очень холодно
храбрый портняжка	смельчак, сообразительный и смелый человек
царевна несмеяна	тихоня, скромница
целовáть крест	целованием креста потвердить истинность своих утверждений
цель оправдывает средства	выражение является одним из девизом ордена иезуитов и сформулировано иезуитом эскобаре-и-мендозе (antonio escobar у mendoza, 1589 – 1669
цыплят по осени считают	об успехе какого-либо дела можно говорить только когда, оно свершится, будет выполнено
чего хочет женщина, того хочет бог	о важности женщин и их желаний
чемодан без ручки	то, что приносит много забот, но от чего жалко избавиться
черный лебедь	аномальное событие, имеющее сильное влияние на происходящее
честь мундира	о чьём-нибудь официальном авторитете, репутации
число зверя	666
чтобы комáр носу не подточил	сделать что-либо таким образом, чтобы оно получилось безукоризненным
чувство локтя	о товариществе, взаимной поддержке
чужими рукáми жар загребáть	пользоваться результатами труда других людей в своих корыстных целях, с выгодой для себя
чумá его знáет	трудно, невозможно сказать что-либо определённое о ком
чёрная доскá	список фамилий людей, отстающих в работе
чёрта с два!	как бы не так! лушка вздохнула и, роя остроносым чириком влажный песок, потупила голову:
шáгу не сделает	кто-либо постоянно делает что-либо неприятное
шапка - невидимка	в сказках: человек, надевший шапку- невидимку, становился невидим для окружающих
шапочное знакомство	поверхностное знакомство
шарашкина контора	несолидное, не вызывающее доверия учреждение, предприятие, организация
шевели поршнями	быстрее (иди, делай
шило в одном месте	непоседа, беспокойный человек
щурить глазá	пытаться разглядеть что-либо, находящееся вдалеке
это не дела, а делишки	про незначительные, мелкие дела (заботы
ягодка - кислица	по отношению к людям с тяжёлым, неуживчивым характером
ёж тебя наколи	выражение, содержащее разные чувства говорящего: любопытство, недовольство, досаду, раздражение чем-либо или кем-либо
без огляду	очень быстро
во всю прыть	быстро
как у зайца теремов	очень много чего-либо
не счесть	очень много кого-или чего-либо
вынать потроха	убивать, лишать кого-либо жизни
отправить на тот свет	убить, умертвить
перервáть глотку	убить, уничтожить кого-либо
постáвить кверху ногáми	уничтожить кого-либо, убить
отпрáвиться на тот свет	умереть
принести оброк богу	умереть
с копыт долой	умереть
едрить твою за кочан	восклицание, выражающее раздражительность, досаду, недовольство, гнев, злобу
дьявол побери	выражение сильного раздражения, досады
пострели его гром	выражение недовольства, досады, раздражения
до глубины души	очень сильно
чертям тошно стáнет	очень сильно
под горячую руку	в состоянии сильного возбуждения, раздражения, гнева, злости
до капельки	полностью, до конца
до нитки	совсем, до конца, полностью
дойти до геркулесовых столбов	дойти до крайнего предела, до абсурда, выйти за пределы разумного
сквозь землю провалиться	исчезнуть
скрыться из глаз	исчезнуть
по сáмые уши	полностью, целиком
с ног до головы	полностью, целиком
в голове мухи кипят	по отношению к неумному, легкомысленному человеку
глуп до святости	чрезвычайно глупый человек
кот наплакал	очень мало чего-либо
выбить бубну	избить, побить кого-либо
пáлку в колёса	намеренно мешать в каком-либо деле
совать палки в колеса	мешать что-то сделать
становиться поперёк дороги (пути	мешать, препятствовать кому-либо в чем-либо
лишиться жизни	погибнуть
на большóй пáлец	очень хорошо, отлично
задыхаться от хохота	смеяться неудержимо, до изнеможения
рáньше рáннего	очень рано
хучь в колодезь кидáйся вниз головою	о состоянии сильного отчаяния
валять дуракá	бездельничать
ваньку валять	бездельничать
оббивáть китушки	бездельничать
плевать в потолок	проводить время в ничегонеделании
попасть в девятку	точно в цель
лихоман их вытряси	выражение сильного возмущения, досады, раздражения
как обухом в темя	совершенно неожиданно, внезапно (ошеломить, сильно взволновать кого-либо
бледнеть от злобы	приходить в состояние крайнего гнева и раздражения
кобелина поблудный	по отношению к гулящему мужчине
под мухой	в нетрезвом состоянии
всё едино	не имеет значения
законы святы, да законники супостаты	применяется неодобрительно к тем, кто применяет закон (судьи, следователи, прокурор, полиция), искажая дух и смысл закона
умá палáта	по отношению к очень умному человеку
когда жареный петух клюнет	никогда
на стáрый лад	так, как было раньше, до революции
по старинке	так, как было раньше
набит деньгами	очень много денег
наступáть на глотку	требовать что-либо от кого-либо, принуждать, притеснять
как попу на духу	откровенно, ничего не утаивая
сказáть начистоту	сказать о чём-либо открыто, ничего не скрывая
короста липучая	выражение недовольства, злобы (по отношению к женщине
в сущности	на деле, в действительности
по существу	на деле, в действительности
вдариться в испуг	испугаться
душа в пятки ушла	сильно испугаться
будь она трижды анафема	восклицание, выражающее очень сильное недовольство, гнев, раздражение
какого рожна	зачем?, почему?
врать как сивый мерин	нагло, беззастенчиво врать
закрывать глаза на что-либо	намеренно не обращать внимания на что-то
смотреть сквозь пáльцы	не обращать внимания
стáрая холера	выражение уничижительного отношения к пожилой женщине
любушка моя	дорогой мой (дорогая моя): по отношению к мужчине и женщине
ни гу-гу	молчать
принять близко к сердцу	сильно переживать о чем-либо
яко тать в нощи	тихо, незаметно
на кудыкино поле	куда-нибудь очень далеко
как на ладошке	когда всё ясно и понятно
заглотнуть язык	промолчать
разделывать под орех	сильно ругать, беспощадно критиковать кого-либо
на грех	будто какое-либо каверзное дело кем-то подстроено
души не чаять	безгранично любить
на сегодня хватит	достаточно
когда жареный петух клюнет	когда терпеть больше уже невозможно
не сводить глаз	пристально, внимательно, неотрывно смотреть на кого-или что-либо
нáша хáта с крáю	это нас не касается, не имеет к нам никакого отношения
сердце содрогнулось	кого-либо охватило чувство сострадания, жалости
дело хозяйское	поступай как хочешь, тебе решать
пошло навыворот	что-либо изменилось в худшую сторону
вбить в голову	запомнить раз и навсегда
замазать рот	заставить замолчать кого-либо
с длинной рукой под церкву	просить милостыню
по всем прáвилам	как полагается
до последнего времени	до настоящего момента
до сих пор	до настоящего времени
решетом воду носить	бесполезное дело
не в духе	в плохом настроении
сроду нет	ни за что
сто чертей тебе в душу	восклицание, выражающее возмущение, негодование, нежелание чего-либо
задать выволочку	строго наказать кого-либо
ни в какую	ни при каких условиях, ни при каких обстоятельствах
тудыт твою	восклицание, выражающее злобу, недовольство, раздражение кем-либо
изо всей дурацкой мочи	изо всех сил
как отче наш	очень хорошо
сыпануть жáру на подхвостницу	сильно наказать кого-либо
глядит в книгу, а видит фигу	невнимательное чтение, неумение правильно понять смысл написанного
разодрáться как бык на сколизи	теряться, раздваиваться в выборе между двумя противоположными решениями
без памяти	ничего не думая
чума его знает	восклицание, выражающее недоумение, негодование, раздражение
чем богáты, тем и рáды	призыв довольствоваться тем, что есть
дело табак	чьи-либо дела очень плохи, положение крайне опасно
в соку	в расцвете сил и лет
заснуть как убитый	заснуть очень крепким сном
от греха подальше	во избежание неприятности
из головы не выходила мысль	о чём-либо, постоянно присутствующем в мыслях
с рукáми и с потрохáми	охотно, с большим удовольствием
во все глаза	очень внимательно
кто ни поп, тот и батька	никакой разницы нет 
царство морфея	сон (обычно крепкий
глаза выколи	очень темно, ничего не видно
лежать на печи	совсем ничего не делать, бездельничать
пáльцем укáзывать	обращать внимание на кого-либо
сбиться с ног	хлопотать до изнеможения
не знать кудá подáться	не знать, что делать, находясь в безвыходной ситуации
вся статья	по всем своим качествам, во всех отношениях
работать сутками/круглосуточно	много работать
отдáть бóгу душу	перестать жить, существовать, умереть
назвался груздем, полезай в кузов	взялся за дело, обозначил, что сможешь это делать – значит и делай. отказываться нельзя
поднять руки вверх	сдаться
крутить носом	выражать недовольство или пренебрежение кем
взбрести на ум	сделать что-либо несуразное, нелогичное
а у вас негров бьют	фраза от анекдота советского периода
принести утешение	успокоить кого-либо
отплатить той же монетой	отомстить схожим образом
пес возвращается на свою блевотину	древняя пословица из библии
разделяй и властвуй	древняя латинская пословица
раз плюнуть	очень легко, не составляет труда, не требует никаких усилий что-либо сделать
пускáть крáсного кочета	устраивать пожар, поджигать что-либо
попасть под раздачу	неожиданно попасть в неприятную ситуацию
старого воробья на мякине не проведешь	опытного человека не обманешь 
протянуть руку помощи	оказать помощь, поддержку кому-либо
кому горевать, а кому зоревать и во сне потягиваться	каждому своё
чёртова дурá	выражает снисходительное, покровительственное отношение к кому-либо
не за горáми	в ближайшем будущем
что не видно	в ближайшем будущем, скоро
ходить фертом	важничать
с рук нá руки	непосредственно от одного к другому
боже упаси	о чём-либо крайне нежелательном
сила солому ломит	о тяжелой работе
дать драло	убежать, удрать
унести ноги	поспешно убежать, удрать, обычно спасаясь от опасности, преследования
была не была	надо рискнуть, попытаться
глядеть в оба	опасаясь чего-либо, быть бдительным, держаться настороже, наготове
брать/взять голой рукой (голыми руками	подчинить себе кого-либо без больших усилий, легко, свободно
ходить в цобах	находиться в тяжелом положении
ни с чем	ничего не узнав, ничего не добившись
на всякий пожарный случай	на всякий случай
набить оскомину	сильно надоесть
ни хóлодно ни жáрко	совершенно безразлично, всё равно
много воды утекло	много времени прошло
ушло много воды	прошло много времени
и вся недолга	и всё тут, и кончено дело, только и всего
хоть зайца гоняй	ничего нет, пусто
до ужасти	очень сильно, в высшей степени
кому не помирать, жив будет	будь что будет 
в час по чайной ложке	очень медленно
глаза на лоб полезли	сильно удивиться
как по команде	разом, дружно
всыпать чертей	выпороть, высечь кого-либо
потерять всякое представление	забыться
к вящей славе божией	девиз религиозного ордена иезуитов
брехать на вéтер	обманывать, говорить неправду
дух захватывало	было тяжело, трудно дышать из
без дальних разговоров	не говоря, не рассуждая много, не теряя напрасно времени
мокрый как мышь	вспотеть от страха
купаться в золоте	быть очень богатым
купаться в роскоши	быть очень богатым
седьмая вода на киселе	очень дальний родственник
видеть наскрозь кого	очень хорошо знать кого-либо, его характер, мысли, намерения, желания
выйти не по гаданному	получиться не так, как хотелось бы
христос с тобой	пусть будет так, ну да ладно
класть голову под топор	рисковать своей жизнью
белый как полотно	очень бледный (о болезненном состоянии
на свой лад	так, как хочется кому-либо
метнуть жребий	решить какой-либо вопрос посредством жеребьевки
ни слóва бóльше	молчи, иначе будет плохо
вставить слово	заговорить
нагнетать атмосферу	преувеличивать серьёзность ситуации
бог дал, бог взял	что-либо пропало
как черти	очень крепко
шубу бей — теплее, жену бей — милее	с женой нужно быть строже 
забить на что-либо	перестать обращать на что-то внимание
много будешь знать - скоро состаришься	употребляется по отношению к чрезмерно любопытным людям
